[
  {
    "id": 1,
    "name": "青青草原",
    "cols": 6, "rows": 10,
    "startX": 0, "startY": 0,
    "map": [
      [0, 1, 1, 1, 1, 1],
      [1, 1, 2, 1, 1, 1],
      [1, 1, 1, 1, 2, 1],
      [1, 2, 1, 1, 1, 1],
      [1, 1, 1, 1, 1, 1],
      [1, 1, 2, 1, 1, 1],
      [1, 1, 1, 1, 2, 1],
      [1, 2, 1, 1, 1, 1],
      [1, 1, 1, 1, 1, 1],
      [1, 1, 1, 1, 1, "E"]
    ]
  }
]